7 11
    9     5    54    41    15    88     7    65    13    69    58
   91    41    74    25    54    13    10    32    34    15    23
   10    42    13    10    27    83    74    55    82    43     7
    9    89    68    19    88    90    25     9    11    52     9
    8     6    13    23    23    22    19    65    50    58    66
   23    52     9    22    13    71     9    90    10    35    11
   11    16    10    33    85    18    31    12     8    10    14