9 9
   86    56    25    33    68     8     8    22    35
   19    83    30    84    91    85    65    87    69
   20    14    40    19     9    25    66     8    24
   13    84    26    53     9    74    14    16    66
   23    13    11    19     5    89    12     4    31
   12    71    11    43    11     7    23    35    90
   84    74    74    39    11    58    17    15    54
   22    11    70    12    11     7    83    57    12
   38    82     9    71    85    18    74    11    83
   
   